How about some testimonies from real health experts?	Also, who's to say there aren't testimonies from "real" health experts on there?
"Then the captain was gone.	Then the captain came back.
The problem is simpler than that.	The problem is simple.
NEGATIVE RECONNAISSANCE REQUIREMENTS.	PACIFIC REQUIREMENTS .
So, I am dropping, for now, asking you the question: " Where ' s the Marx " ?	I am moving on to ask you the question: " Where ' s the beef " ?
go figure You're asking me to prove a negative?	You're asking me to prove a negative?
I am OK with MEDICAL use!	I AM OK WITH MEDICAL USE!!
The prices for everything you need have gone up due to inflation.	The prices of everything you own IE assets have gone down.
War in the middle east.	A WAR in the middle east.
Originally Posted by Vienna How was it authoritarian?	Originally Posted by zaf I give up.
Imagine a place that's % white and % black.	Imagine a place with % men and % women.
There's no chance of a fair trial.	there is no chance at a fair trial.
Nirvana is very different than oblivion.	Nirvana is NOT oblivion.
We in Britain think differently to Americans.	Originally Posted by zaf We in Britain think differently to Americans.
If you answer yes to  and no to  you are probably straight.	If you answer no to  but yes to  then you are probably straight.
The whole earth combined produces enough food for  billion people.	Who does it now only produce enough for  billion?
BTW he had appropriate deferments for the time.	Appropriate deferments for the time, eh?
Hey, Blue-Eyes, How's things in London?	**smooches Ran** Hey, Blue-Eyes, How's things in London?
but in the news broadcasts i have seen they did call him white.	but it seems it would have less "impact" if they didn't call him white.
According to the girlfriend and Zimmerman, he did.	According to Zimmerman he did.
My parents have told me it is bad for you.	My teachers have told me it is bad for you.
.Nazi is a slang term for the NSWP.	Originally Posted by Odins eye .Nazi is a slang term for the NSWP.
I oppose the death penalty.	This is why I support the death penalty.
Well, whatever, you are now.	Well, whatever, you're aware of it now.
They produce nothing I can eat, wear, live in.	Think about all the things you can't "eat, wear, or live in".
DICKSHOT Matt Holliday owns.	Matt Holliday owns, y'all.
People exploited the laws.	People bent the laws.
Funny, I thought the same thing about some math.	And here I thought I knew me some math.
I have  years of "Neener Neener" rights I use lettuce too.	I have  years of "Neener Neener" rights Hi Wiggies!
I don't prefix or suffix everything with "you hate Jews."	You should stop prefixing or suffixing everything with you hate Jews.
I wood have asked her if she is up for a treesome.	I wood have at least asked if a threesome was out of the question.
It still makes no sense.	It's you who makes no sense.
More expensive homes.	More expensive cars.
Martin said, "Why are you following me?"	Zimmerman replied, "What are you doing here?"
ALTHOUGH SATELLITE INTENSITY ESTIMATES FROM TAFB AND SAB ARE ONLY T./	SUBJECTIVE DVORAK INTENSITY ESTIMATES FROM TAFB AND SAB INCREASED TO  KT.
"Fairies don't exist" - fine.	"Satyrs don't exist" - fine.
You wanna know what I find curious?	That's what I find curious.
When did I compare homo sexuaity with a developmental disorder?	I compared homo phobia with a developmental disorder.
If you asked , conservatives, the numbers will be skewed to the right.	If you asked , progressives, the numbers would be skewed to the left.
You didn't mention PFA before that one post.	I didn't mention restraining order either.
Ramblin' Rose by Nat King Cole We are all vessels filled with many wonders.	Eye of the Tiger We are all vessels filled with many wonders.
from the year prior.	 warmed.C from the year prior.
Still love this show.	Holy poo poo, this show.
their vast properties are protected by the govt.	their great wealth is protected by the govt.
Fundimental difference, please?	Fundamental difference?
How exactly is Germany being 'punished' for the stupidity of WW?	How exactly are they being punished?
Z stalked him down, then shot him.	You claimed Zimmerman " Stalked him down, then shot him ".
I'm not outraged, I'm disappointed.	God bless I'm not outraged, I'm disappointed.
We never got out of it in the first place!	Where does the money come from in the first place?
Freedom of speech has consequences!	If freedom of speech has consequences then it is not free.
My parents have told me it is bad for you.	My teachers have told me it is bad for you.
if you could kill one person to save four, would you?	As to would I kill  person to save , I have no idea.
It's not imposing morals.	It's imposing a law.
It depends how you define extreme.	Depends on how you define "extreme".
At least Mexico had a presence in California.	Mexico has ZERO claim to California.
So YES, we DO read the bible to learn about Christianity.	personally i would read the bible to learn about christianity.
Ah ha, ha, ha, ha, ha!	Ha, ha, ha, ha, ha, ha!
And that's why you're yelling at me and refusing to answer my questions?	Still refusing to answer my questions?
You have too much regulation, not too little.	You have to much intervention in free markets, not too little.
The Human Element You could sign Lance Berkman at the end of the year I guess?	You could sign Lance Berkman at the end of the year I guess?
Why was the Book of Thomas left out of the canon?	Why would the addition of more of Jesus words be left out of the canon?
You mean, you believe the word of the Mainstream Media?	You mean, you believe the word of the SpringHallConvert?
We are meant to explore.	We are meant to move.
Israel doesn't give a ****, accept it.	That Israel doesn't giva a **** what anybody else thinks.
We are all vessels filled with many wonders.	I Want to Rock and Roll by Kiss We are all vessels filled with many wonders.
Slutstamp! A dear friend from Ohio sent me this.	A dear friend from Ohio sent me this.
And yet, the Titanic story is the one that holds up to scrutiny of the evidence.	The new study shows that the Titanic story does not stand up to scrutiny imo.
Can he really make mone from google ad sense.	Who makes money off google ad sense?
They know that the video doesn't show a gas chamber.	The bottom line is that the video clip doesn't show a gas chamber.
Warm , maybe record.	Warmer , almost certainly a record.
"Bright but scatterbrained" becomes "treat with drugs".	"Opinionated and stubborn" becomes treat with drugs".
What is your definition of "life"?	What's your definition of nature?
Could be a lot of things.	Could be a simple mistake.
No extortion, no bribery, no money involved He's asking for money for his vote.	No extortion, no bribery, no money involved Only class E felonies.
Dr. Neander's revised version.	Neander's revised version"?
Should I just tell her how I feel?	Should I just wait it out and see how it goes?
I. ATLANTIC REQUIREMENTS .	PACIFIC REQUIREMENTS .
you have no remains of a missile at the pentagon.	you have no witnesses for a missile at the pentagon.
"Jane" wants me to ask the helpful party guest to pay for it.	I can't believe she is asking YOU to ask the helpful party guest for money!
any woman that wants birth control can get it.	Any woman that wants and abortion can get one.
Is it legal to grow?	Yes, it's legal to grow.
pressing one does not "do" english.	Pressing one does send a tone.
What's my opinion regarding the series?	What was my opinion of Firefly in the interim?
We are all vessels filled with many wonders.	Chuck Close We are all vessels filled with many wonders.
Does he have supporters?	He definently has supporters.
but okay, ultimate sovereignty?	Thus, ultimate sovereignty.
that is not an answer.	no, it's not an answer.
The Nazis increases the longevity of a handgun permit from  to  years.	The Nazis lowered the minimum age to buy a firearm from  to .
But we can't do it without help.	We can't do it without you."
No healthy person needs gambling.	No healthy person needs sex.
I said it wasn't a person, in the legal sense.	If it isn't a person, then WTF is it?
Do you see Obama calling for regulation reform?	Do you see Obama calling for Cut, Cap and Balance?
"Leprechauns don't exist" - fine.	"Elves don't exist" - fine.
Got some Heine and coors light i started it last night xanis.	i started it last night xanis.
Iran is also a signed of the NPT and the IAEA.	Gotta love the EK factoid that "Iran is also a signed of the NPT and the IAEA.
"Gorgons don't exist" - fine.	"Satyrs don't exist" - fine.
Best way to get money out is to get rid of lobby, all of it.	Best way to turn it on its head is to get money out.
I have  years of "Neener Neener" rights Usually I get pretty decent care.	I have  years of "Neener Neener" rights they are crack ups.
Dutchy Has anyone heard from Dutchy?	@NickFun, Has anyone heard from Dutchy?
Commodity Expanded Value-Form, .	Elementary Commodity-Capital Value-Form .
You are a Christian.	Therefore you are not a Christian.
And the simple fact today?	I repeat: And the simple fact today?
Morals have absolutely nothing to do with it !	and morals and honesty have everything to do with it.
"Oh, you're such a good person!	You're such a bad person!"
Fern I think stories like this are stupid.	- wolf I think stories like this are stupid.
CYCLONE FORMATION IS NOT EXPECTED DURING THE NEXT  HOURS.	TROPICAL CYCLONE FORMATION IS NOT EXPECTED.
Do you not understand what that string of words means?	Do you not understand what the word 'led' implies?
There is no freedom of religion.	There is no freedom of speech.
Originally Posted by SolInvictus The messahe of all the scriptures is oneness.	Originally Posted by SolInvictus Ah.
How long after the obliteration should the kid return to school?	How long after the obliteration should it no longer bother the kid?
A man and a woman are different yes.	Men and women are different yes?
Double Jeopardy actually enforces a jury nullification.	As far as legality goes I can use jury nullification.
Facilitator : Show me the smart child.	Facilitator : And why is she the dumb child?
religious fiction Isn't that redundant and repetetive?	Isn't that redundant and repetetive?
Originally Posted by anabelle What's wrong with that?	Originally Posted by Vienna To 'say' what?
Cracklin' Rosie by Neil Diamond We are all vessels filled with many wonders.	Jingle Bell Rock by Bobby Helm We are all vessels filled with many wonders.
Some people have complete confidence in the people running these institutions.	Other people have no confidence at all in teh people running these institutions.
loose change started out as a work of fiction.	It finished as a work of fiction.
If it wasn't a life, then it would not be able to be born.	If it wasn't alive, then it would miscarriage on it's own.
GL, Terral That is absolutely amazing.	Hi Ollie: That is absolutely amazing.
lets assume we have % white and % black.	Imagine a place that's % white and % black.
Freedom of speech has consequences!	If freedom of speech has consequences then it is not free.
"Fairies don't exist" - fine.	"Leprechauns don't exist" - fine.
If so, state that is why they're not true.	Please, what about them are not true.
-Not- talking about it 'and' -Not- doing anything.	is even worse than talking about it and not doing anything.
"Being against nukes" does not mean "not wanting to use nukes".	"Being against using nukes" means "not wanting to use nukes".
My niece is married to a black man.	My great niece is half black.
The UK population is just over  million.	The Japanese population is nearly  million.
I Shot the Sheriff We are all vessels filled with many wonders.	We are all vessels filled with many wonders.
I hope this is nothing.	I hope everything is ok!
The money I spent adopting Velociraptor.	Those may be my top . The money I spent adopting Velociraptor.
So, you actually believe every word of what Terral wrote?	GL, Terral Hi Corn: So, you actually believe every word of what Terral wrote?
What isn't how what was sold?	It's not how it was sold, gb.
I know I'd hate to be him.	I'd hate to be him too.
there were no weapons.	Of course there were no weapons.
It's so stupid that it just has to be true.	It's amusing to think it even might be true.
Personal responsibility much?	Again, personal responsibility.
Do you notice the nonsensical things you are saying?	And to be fair, do you notice the nonsensical things you are saying?
I guess I pulled it out of the census's rear end in a top hat.	Does the census have an rear end in a top hat?
How is this slanted against Bush??	Where is the slant against Bush?
If it wasn't bollocks it wouldn't be homeopathy.	That's simple logic If it wasn't bollocks it wouldn't be homeopathy.
I've never accused him of over-milligraming, nothing.	I've never accused him of doctoring a baseball.
The bailout was bigger than TARP Bloomberg news.	The bailout was bigger than TARP This title is misleading.
My parents have told me it is bad for you.	officers have told me its bad for you.
His position is that it is the individual's risk to assume.	His position is the way it is currently.
I. ATLANTIC REQUIREMENTS .	PACIFIC REQUIREMENTS .
Read More: You have never met anyone that is Pro-Abortion?	You have never met anyone that is Pro-Abortion?
I have no problem with those that have money!	I have many problems with these men, way to many to state here!
Nixon, Ford and Carter shut down the oilfields?	No has has shut down the oil fields.
i don't want a president who 'cares'.	i don't want a president who is charasmatic.
It doesn't have to be braindead.	I don't have a proposed model.
no missile evidence.	no missile witnesses.
My teachers have told me it is bad for you.	officers have told me its bad for you.
My gosh, I'm the one with the pregnancy ticker.	I have the pregnancy ticker.
Then he is not omnipotent.	Then he is malevolent.
tin foil hat for the dog face, what size do u wear?	tin foil hat for the sarg, what size do u wear?
Like this  year old who was shot dead in a marijuana-related crime.	Or the  year old boy shot dead with automatic weapons by marijuana dealers.
If you leap up to make a hit, you're getting a penalty.	If your stick hits a guy in the face, you're getting a penalty.
ALL of the electrical energy comes from the battery.	ALL of the electrical energy ultimately comes from the alternator.
Do you know how many passengers testified or what they said?	How many passengers said they saw an iceberg?
Imagine a place with % men and % women.	Imagine a place that's % white and % black.
Scenario A assumes that the CO growth rate accelerates by .%/yr.	It assumes that methane growth rate accelerates by .%/yr.
They have actually showed a cooling trend since  due to the recent decline.	get a cooling trend from  because of the recent decline.
We are all vessels filled with many wonders.	Landon Memory from CATS We are all vessels filled with many wonders.
to repeat: They are NOT as sovereign as they were before.	They are NOT as sovereign as they were before.
Out of touch and completely untrustworthy, however, wouldn't.	Out of touch and untrustworthy?
It is mostly just the Dutch.	In fact, it's just the Dutch.
We're talking about angels and common pins again, right?	@Lustig Andrei, We're talking about angels and common pins again, right?
claims about trayvon's character And when did I do that?	slanted blogs And when did I do that?
% How much money does PP take in for abortion services?	How much is spent on abortions services?
Why did that transaction take place.	Did the transaction take place?
There is no more egg cell post-fertilization.	There is no more sperm cell.
Lacey - welcome back!	Anyway, welcome back.
More factchecking: I don't know why anyone is making a fuss over the $, bet.	I don't know why anyone is making a fuss over the $, bet.
If you haven't made any claims, then just say so.	I haven't made any claims.
No Thatcherite can ever call themselves a libertarian.	Ergo it offends me when Thatcherites call themselves libertarian.
the problem isn't who has money.	the problem is who doesn't have money.
But do you actually believe there was an iceberg in those waters?	I don't believe there was any iceberg at all anywhere near the Titanic.
not astros or orioles bad Gameday for the orioles game is frozen for me.	Gameday for the orioles game is frozen for me.
If so, alot of cops should take presciption drugs.	If so, alot of inventors, writers should take prescription drugs..
Tell us what the charges were.	Yes what are his charges.
Those are partial psychopaths.	Was Ted Bundy a partial psychopath?
those who ignore history are doomed to repeat it.	ooo strike TWO those who ignore history are doomed to repeat it.
this is NOT a war deployment.	its not an official deployment.
Nutrax The plural of anecdote is not data Did gentlemen need chaperones?	Nutrax The plural of anecdote is not data
Alright just got in.	not well Alright just got in.
h and i both read the books and thought the movie moved so quickly.	I haven't read the books, but I saw the movie today.
That's not the Moloch scene, though.	This is the Moloch scene.
@Lustig Andrei, So Lyndon Johnson and John Kennedy were compatible?	@edgarblythe, So Lyndon Johnson and John Kennedy were compatible?
You need to make up your mind.	You need to polish up on your logic skills.
The one that has  walks home afterwards and goes to sleep.	The one that has three walks home and beats his wife.
- Admin DrPizza and i'd forgotten what a whiny little bed wetter you are.	and i'd forgotten what a whiny little bed wetter you are.
The argument was "Albert Einstein didn't go to college".	OMG, "Einstein didn't go to college."
Capital gains, top rate:  percent.	Income tax, top rate:  percent.
Bienging is unaccptable.	Being drunk is unacceptable.
He hasn't been funny in years.	He hasn't been funny since Larry Bud Melman was on the show.
If the universe has an explanation of its existence, that explanation is God.	Therefore, the universe has an explanation of its existence.
What do we get in return for doing the fighting for them?	------ ----------- What do we get in return for doing the fighting for them?
It wouldn't stop joke marriages.	And I don't fight for marriage.
If they were Jews, I would call them Jews.	If they were Catholics, I would call them Catholics.
She was a great lady.	She was a nice lady.
He's not wealthy because he's successful.	Why hate people because they are successful?
Not as irritated as you.	You seem as irritated as Henry.
It's a common sense/deductive reasoning thing.	Hilited your common sense/deductive reasoning thing.
You already did that - we have a Muslim in office right now.	-CryptoLutheran No. We have a Christian in office right now.
I said she has not ever had to be a part of any workforce.	Ann Romney has never had to get out and be a part of the workforce.
DreamTech never been ejaculated on as far as I know.	It has never been ejaculated on as far as I know.
I didn't say we had gotten soft since / Rand.	I said YOU had gotten soft.
We all believe that we are getting what we expect.	Most times, % of the time, we are getting what we expect.
Despicable Ben, Stop trying to find excuses for the man.	Ben, Stop trying to find excuses for the man.
Unless it's different in different countries?	So, short form, yes, it probably is different in different countries.
The new study does not support your claim.	The physical evidence does not support your claim.
He said at EVERY level.	But he said EVERY level.
morals do not exist, so technically nothing can be morally wrong.	I ask again if God does not exist can anything be morally wrong?
I thought that was mostly just the Dutch.	It is mostly just the Dutch.
Toyland by Johnny Mathis We are all vessels filled with many wonders.	Eye of the Tiger We are all vessels filled with many wonders.
Let's let this play out in court.	Nothing is stopping this thing from playing out in court.
Being in a gang isnt a crime.	Commiting a crime in a gang is a crime.
I'd offer Iran a deal.	Chuck I'd offer Iran a deal.
Yes, they are both different.	Opinions are different.
It's not imposing morals.	It's imposing a law.
Has Annie ever used her sexuality like that?	One word: Zombies Has Annie ever used her sexuality like that?
PURE COMMUNISM: You have two cows.	LIBERTARIAN/ANARCHO-CAPITALISM: You have two cows.
You should put scientists on a pedestal.	Why do people like you put scientist on a pedestal?
What are they trying to hide?	I then asked: What are they trying to hide?
That would make you partially responsible for their death.	That would make you a sort of accessory, I think.
"Would you like to pay for others health care?"	"Would you like to wear your seatbelt?"
They are NOT as sovereign as they were before.	to repeat: They are NOT as sovereign as they were before.
I don't see Obama as the lesser of two evils.	I don't see him as evil at all.
Or this one by Jim Croce We are all vessels filled with many wonders.	We are all vessels filled with many wonders.
The point is an unarmed child was murdered.	The point is an unarmed child was murdered who was black.
Zimmerman replied, "What are you doing here?"	Martin said, "Why are you following me?"
Irreligion that does that I have a problem.	Religion that doesn't do that I don't have a problem with.
If I'm angry, it will show up in one of those scans..	If I'm hyper active, it will show up in one of those scans..
If you want to buy $ billion in XYZ Inc. common stock, who cares?	If you want to buy a house or a SUV, again, who cares?
 billion . Everyone in the world at Mexico's current prosperity level.	Everyone in the world at the current "prosperity" level of Northwest Africa.
If you answer yes to  and no to  you are probably straight.	If you answer no to  but yes to  then you are probably straight.
Sometimes I fantasize about having power.	Sometimes I, too, fantasise about bending people before my demented will.
My parents have told me it is bad for you.	My Sheriff has told me its bad for you.
Atlas Shrugged It's also a stellar performer in terms of blithering idiocy.	It's also a stellar performer in terms of blithering idiocy.
How would Martin not know that that was not the case?	How would Martin or anyone else know his intentions based on his actions?
Regulation get the government into everything.	"Get the government into everything?"
It's a common sense/deductive reasoning thing.	Hilited your common sense/deductive reasoning thing.
Yes, I've assumed that all packaging would be recyclable in my argument.	I've assumed this as well in my argument.
Jury nullification does not mean that a law is unconstuitutional.	Jury nullification means a law isn't Constitutional?
It's just a bunch of cells.	I'm "a bunch of cells."
Mann's work was all about math.	Mann's work and the HS was all about Tree rings.
I'm so sorry to hear this Kelly.	I'm so sorry, Kelly.
I don't like flavored beers.	I don't like many flavored drinks.
I hope everything is ok!	I hope your LO is ok.
any woman that wants birth control can get it.	Any woman that wants and abortion can get one.
S As you wish: Do you see Hitler killing Jews?	Do you see Hitler killing Jews?
And I'm your friend Mitt.	Your good friend Mitt.
It means its AN option.	Doesnt mean its a BAD option.
I think you need to reread what I wrote.	You need to reread what I wrote.
lets assume we have % white and % black.	Imagine a place that's % white and % black.
Mom busted in and said, "What's that noise?"	My kids busted in and said 'whats that Dad?'
My best, Kutte My ex-fiance wouldn't use the VA or Navy doctor's.	Jay My ex-fiance wouldn't use the VA or Navy doctor's.
Holder filed a three-page letter.	The Judges orders a three-page letter to be filed.
@Lustig Andrei, Lustig, agreed.	@Lustig Andrei, Thank you, Lustig.
This eclipses the old record of  set in .	This breaks the daily record of  set in .
Zimmerman replied, "What are you doing here?"	Martin said, "Why are you following me?"
I don't know how legitimate this is, but I heard he's kind of suicidal.	So, I don't know how legitimate this is but yeah.
council tax Hasn't council tax been frozen for most people?	Hasn't council tax been frozen for most people?
Your schtick is getting stale.	Your misogyny is getting messy.
Is that how it works?	Nah, that's not how it works.
Breathe In, Breathe Out, Move On.	buwhahahaha Breathe In, Breathe Out, Move On.
wait until they become more consistent and closer together.	wait for the contractions to get stronger and closer together.
Obama is extreme and leftwing.	Obama is part of the extreme leftwing.
@Frank Apisa, What you want to call it is up to you.	@Cyracuz, What you want to call it is up to you.
Jury nullification has NOTHING to do with the Constitutionality of laws.	Jury nullification means a law isn't Constitutional?
What conviction where you talking about before?	What conviction would that be?
So I actually read the OP and guess what I found out.	Furthermore I found this: So I actually read the OP and guess what I found out.
The government does not determine if you are married or not.	The government doesnt have to declare you married before you can be married.
Democracy is a threat to liberty.	Democracy has nothing to do with liberty.
Hi Pro and Corn: How many threads do you plan on making?	How many threads do you plan on making?
Tell me exactly which system isn't working right now?	So which system isn't working for us?
Oh, and again asserts that marriage is a fundamental human right.	Particularly after stating that marriage is a fundamental human right.
Why are Russians in Damascus?	Russians in Damascus!
Yes, it's about dilution.	Er, that's not how dilution works.
Yeah, I don't think this is that controversial either.	I don't think what she's saying is that controversial.
Operation Chaos is merely people voting.	Chaos is merely people voting.
Originally Posted by JonD Doubtful.	Originally Posted by eleanor.ellis
Classical Gas We are all vessels filled with many wonders.	The theme song to Cheers: We are all vessels filled with many wonders.
to repeat: They are NOT as sovereign as they were before.	They are NOT as sovereign as they were before.
Morals have absolutely nothing to do with it !	and morals and honesty have everything to do with it.
i be having conversations will cornell west My dear brother.	i be having conversations will cornell west What the hell is this?
There is no war in the Middle east.	There is no "WAR" in the middle east.
He had no intention of apprehending him.	- I didnt say he planned on apprehending him.
We are all vessels filled with many wonders.	Put a Little Love in your Heart We are all vessels filled with many wonders.
You're "a bunch of cells."	I'm "a bunch of cells."
What is a girl douche?	You are a girl douche.
Jury nullification means a law isn't Constitutional?	No. Jury nullification does not mean that a law is unconstuitutional.
It's definitely NOT what it used to be.	voted Voted It's definitely NOT what it used to be.
The onus is on the manufacturer of a product to convince consumers it is safe.	The manufacturer has to convince the government it's safe.
I think you are missing the point with entrepreneurs.	Again I think you are missing the point on the Twain quote.
"Cyclopes don't exist" - fine.	"Goblins don't exist" - fine.
"In  it was a mental illness, now what are they teaching you?"	He stated that it was a mental illness in , how is that bigotry?
Landon And So This is Christmas We are all vessels filled with many wonders.	Play With Fire We are all vessels filled with many wonders.
Bush gets zero credit for the budget under him.	And, Obama gets zero credit for the budget under him.
. Sinful people do not get to heaven.	Or sin is removed upon entry to heaven.
How long after the obliteration should the kid return to school?	How long after the obliteration should it no longer bother the kid?
Holly Holy We are all vessels filled with many wonders.	Say What You Will We are all vessels filled with many wonders.
What was the "answer" in Chicago?	What will be the response in California?
The entire thing just makes no sense.	See that makes no sense.
Who supposedly operated the homicidal gas chambers?	Refresh your memory: Who supposedly operated the homicidal gas chambers?
Therefore, the explanation of the existence of the universe is God.	If the universe has an explanation of its existence, that explanation is God.
Genetic predisposition to cancer resistance is superior genetics.	Genetic predisposition to Alzheimer is inferior genetics.
Do you notice the nonsensical things you are saying?	And to be fair, do you notice the nonsensical things you are saying?
Use of force in defense of person.-A	Use of force by aggressor.
That's what the data available shows.	That's what the historical record shows.
Joy to the World We are all vessels filled with many wonders.	The theme song to Cheers: We are all vessels filled with many wonders.
I thought that was mostly just the Dutch.	In fact, it's just the Dutch.
Ive watched kids play.	I like watching kids play.
David @OmSigDAVID, I think Santorum's more likely than Gingrich.	@sozobe, I think Santorum's more likely than Gingrich.
They're looking at each other!	Why are they looking at each other like that ?!?!
Are you driving one?	Are you driving a fucking Volt?
Religion that does that I have a problem with.	Irreligion that doesn't do that I don't have a problem with.
I think he'd be better for American business interests overall.	Would he be better for American society?
not a constitutional issue.	again, this is not a constitutional issue.
YOU FOOLS..bought the  cover-up..hook..	Hi Eots: YOU FOOLS..bought the  cover-up..hook..
"What does pressing the number one do?"	"Pressing the number one does English."
What conviction would that be?	What conviction where you talking about before?
Originally Posted by spikdboy Not wishful thinking, rather realistic.	Originally Posted by objectivism Not wishful thinking, rather realistic.
For the trillionth time, I've never said rehabilitation doesn't work.	The point you quote should say "I never said rehabilitation could never work."
Charlie Rangel Censured Did anyone see the footage of this?	Did anyone see the footage of this?
Red October standing by.	Red Fox standing by.
That's just not how legal briefs are written.	That just isn't how legal reasoning works.
No, none of those factors account for the recent warming.	You don't know if those factors account for the warming, or not.
Stone notified Captain Lord.	He too notified Captain Lord.
The primary focus of Systematic Dialectics is syn chronic, not dia chronic.	Thus, Meta - System - atic Dialectic is Diachronico - Synchronic Dialectic.
Are you driving one?	Are you driving a fucking Volt?
And that is happening in GOP controlled states.	Michigan IS a GOP controlled state.
in  Foxe basin was frozen.	 Foxe was mostly frozen.
@Frank Apisa, Frank, I observe and perceive.	@cicerone imposter, Frank, I observe and perceive.
Government deciding what pregnancies need to be carried to term, that's fine.	Government spying on its own citizens, that's fine.
Put a Little Love in your Heart We are all vessels filled with many wonders.	Landon And So This is Christmas We are all vessels filled with many wonders.
Higher than  per cent but not very high.	Lower than  per cent but not very low.
What isn't how what was sold?	It's not how it was sold, gb.
God definately does not exist.	God probably does not exist.
Breathe In, Breathe Out, Move On.	buwhahahaha Breathe In, Breathe Out, Move On.
It is an excellent indicator of climate change.	I think we all agree on the nature of the change.
The great thing about living here is there's space.	The bad thing is there's space.
Ah ha, ha, ha, ha, ha!	Ha, ha, ha, ha, ha, ha!
I don't understand how freedom of speech will be prohibited.	Your freedom of speech will be no more prohibited than it is today.
The question needs to be asked.	It is a question that needs to be answered.
You purport to value life very heavily.	I purport to value human life very highly.
The Infestation posts.	The mosquitoes posts.
i don't want a president who 'cares'.	don't want a president that is compassionate.
do you have anything to make it less compelling or not?	Do you have anything to make it more compelling?
For the trillionth time, I've never said rehabilitation doesn't work.	The point you quote should say "I never said rehabilitation could never work."
Classical Gas We are all vessels filled with many wonders.	Time of the Season by the Zombies We are all vessels filled with many wonders.
peeve So we agree that it came down essentially in freefall?	Do we agree that they came down essentially in freefall?
Pro-life people do not want a woman to be able to choose abortion for herself.	Pro-choice people do not try to force an abortion on anyone.
So answer the question.	Stop avoiding the question.
Haiti is a shithole.	Haiti has been a shithole.
I absolutely do believe there was an iceberg in those waters.	I don't believe there was any iceberg at all anywhere near the Titanic.
The Face Of The Franchise: The worst part is that he's not even a Leafs fan!	The worst part is that he's not even a Leafs fan!
I agree completely I am hoping he is into a second term of office.	I am hoping he is into a second term of office.
Jake with the assist.	Voracek with the goal.
Is it possible his home was affected and the school was not?	Sure, it is possible his home was affected, but not the school.
The people had awakened.	Because the people had awakened.
Umm the California was a cargo ship I dont care what the article says.	The California was a cargo ship.
Umm, that pretty clearly states, "the statute is presumed constitutional."	And until they decide that, "the statute is presumed constitutional."
Florida The ignorance is yours!	The ignorance is yours!
I'm going to shout for justice for Trayvon.	The people shouting for justice for Trayvon are all hypocrites.
How do you know what's right and wrong?	How do you know which story is the right one?
Ha, ha, ha, ha, ha, ha!	Ah ha, ha, ha, ha, ha!
And Nugent was a complete fool to say what he said.	Natalie was a complete fool to have insulted their fan base.
It is all Bush's fault.	Obama is Bush's fault.
You should stop prefixing or suffixing everything with you hate Jews.	I don't prefix or suffix everything with "you hate Jews."
I missed the point where he said that black people were going to riot.	Never, did I ever, did I say blacks were going to riot.
Yet you didn't have to declare it.	And you didn't have to.
Proverbs  John the Baptist was a Nazarite from birth.	John the Baptist was a Nazarite from birth.
James : says faith without works is dead.	Paul did not preach faith without works.
 billion . Everyone in the world at Mexico's current prosperity level.	Everyone in the world at the current "prosperity" level of Northwest Africa.
and videos Seismic data does not equal duration of collapse.	Seismic data does not equal duration of collapse.
Originally Posted by Lone Fox You've said that multiple times now.	Originally Posted by Lone Fox And it's not all Iranian related either.
You might not like Obamas views, but he has them.	You might not like the positions he holds, but atleast he has them.
But do you actually believe there was an iceberg in those waters?	I absolutely do believe there was an iceberg in those waters.
There is simply no winning for Obama among conservatives.	This is rich coming from a conservative.
Satan represents indulgence instead of abstinence!	. Satan represents vengeance instead of turning the other cheek!
Just so long as the tax on that sale is paid.	Just so long as the tax is paid.
fix?: Islam itself is not political.	Islam has always been political.
March  is also the date for the uprising in CHINA.	Originally posted by Vitchilo March  is also the date for the uprising in CHINA.
I hope everything is OK!	I hope everything is okay.
Do you understand why it's absurd to limit the question to US residents?	Do you understand why non-US residents are also relevant to the statistics?
I have seen UFO over Warsaw in the past.	Respectfully submitted, Steve I have seen UFO over Warsaw in the past.
depending on which action furthers their loony-tunes agenda of the moment.	depending on which action furthers their lonny-tunes agenda.
Do you further agree that I have made no claim?	So that you will admit and verify that I have made no claim.
Zimmerman says that he was sucker punched by his car.	His "friends" say that he was confronted by his car.
There is no "WAR" in the middle east.	There is no war in the Middle east.
Part of pro-life is the opposition to legalized abortion.	Pro-life also refers to just "opposition to abortion".
Capital gains, top rate:  percent.	 - Income, top rate:  percent.
Time of the Season by the Zombies We are all vessels filled with many wonders.	The theme song to Cheers: We are all vessels filled with many wonders.
No, I show you are willfully ignorant.	LOL, you are so ignorant.
We are all vessels filled with many wonders.	Jingle Bell Rock by Bobby Helm We are all vessels filled with many wonders.
the problem isn't who has money.	the problem is who doesn't have money.
Sadly Ford did accept taxpayer money.	Ford didn't accept taxpayer money to save the company.
The Muslims would say the same thing about the Qur'an.	The Hindus would say the same thing about the Bhagavad Ghita.
Your confusion doesn't make me a liar.	Then your confusion doesn't make me a liar either.
When Christians are extreme its just simply religion.	When Muslims are extreme it's terrorism.
Some believe the 'right' is most important.	Some believe not slaughtering the unborn is most important.
Evolution is not an opinion, not a belief.	Atomic theory is not an opinion, not a belief.
I am not the one claiming the right to decide over another woman's body.	You want others to decide over a woman body.
Where in the world is Ron Paul?	Where in the world is the MEDIA??
you have no remains of a missile at the pentagon.	you have no remains of an A- at the pentagon.
The point you quote should say "I never said rehabilitation could never work."	For the trillionth time, I've never said rehabilitation doesn't work.
 billion . Everyone in the world at Mexico's current prosperity level.	Everyone in the world at the current "prosperity" level of Northwest Africa.
my hair is pretty thing tho :/ Quote: Ditto.	my hair is pretty thing tho :/ woops!
It wouldn't stop joke marriages.	And I don't fight for marriage.
You seem to think that poor people are not responsible for their actions.	People are responsible for their actions.
Why did that transaction take place.	Did the transaction take place?
It's about the baggage attached.	It's not the same thing.
We are all vessels filled with many wonders.	Put a Little Love in your Heart We are all vessels filled with many wonders.
the problem isn't who has money.	the problem is who doesn't have money.
What makes you think the owl didn't participate?	It doesn't say that it didn't participate.
lol Looking forward to seeing your built-in's!	Look forward to seeing it!
Originally Posted by jacko!	Originally Posted by IZZY!
Thanks Candy for starting the thread.	Candy - Thanks for starting us off today.
Except that it wasn't.	Except that they couldn't.
If I owe you , dollars, I have a problem.	If I owe you a trillion dollars, you have a problem.
If evidence is not provided to support a position; then it should be rejected.	If a position is unverifiable; then it should be rejected.
Everyone else at the current prosperity level of Mexico.	Everyone in the world at the current "prosperity" level of Northwest Africa.
Bush gets zero credit for the budget under him.	And, Obama gets zero credit for the budget under him.
LOL Don't you have to take a test to drive a vehicle in the US?	Is there a test to own a firearm in the US?
We both thought the movie was good and we didn't find it confusing in any way.	I thought it was good, and I didn't find it confusing.
If God does not exist can anything be morally wrong?	I ask again if God does not exist can anything be morally wrong?
A law is constitutional if it does not conflict with the Constitution.	To be unconsititutional means to violate the constitution.
Originally Posted by muslim girl ooops sorry!	Originally Posted by muslim girl its not a complete impossibility.
This is not your country.	This is our country.
Originally Posted by zaf I suppose the water in the middle makes a difference.	Originally Posted by zaf in the long term, yes.
Cone threw an  game.	Addie Joss Cone threw an  game.
Edited by LashL: Edited to properly mask profanity.	Edited by LashL: Edited to properly mask profanity in quoted post.
The jury is not told about juror nullification.	The quote you provide has nothing to do with jury nullification.
runs victim down Got any proof?	paranoid Got any proof?
you don't use the search button much, do you?	you don't use the search button AT ALL, do you?
I don't think Paul has a shot.	Paul doesn't have a shot.
Time of the Season by the Zombies We are all vessels filled with many wonders.	Joy to the World We are all vessels filled with many wonders.
Do you notice the nonsensical things you are saying?	And to be fair, do you notice the nonsensical things you are saying?
What if they messed up a study?	What if they had a personal bias?
Specifically a Baptist.	Specifically Gnostic.
And a large part of the east coast.	And parts of the west coast.
Why are you talking about women within the Hebrew tribes?	We were talking about women as war bounty were we not?
Last night Japanese forces attacked Hong Kong.	Last night Japanese forces attacked the Philippine Islands.
. What is your definition of "life force"?	What is your definition of "soul"?
That is not direct responsibilty to the constituents.	Aye but they ARE responsible to their constituents.
The ideology was built around violent expansion, so yes - VIOLENT expansion.	The ideology was built around violent expansion and race superiority.
Could this have been an enema?	@ossobuco, Could this have been an enema?
my final word: ignoring has the effect of normalizing.	taking advantage has the effect of reinforcing.
